

1111111111119...................................................................................................................................8111111111111
0000000000002...................................................................................................................................3000000000000
0000000000002...................................................................................................................................3000000000000
0000000000002...................................................................................................................................3000000000000
0000000000002...................................................................................................................................3000000000000
0000000000002...................................................................................................................................3000000000000
0000000000002....................................811111111119...................................................................................3000000000000
0000000000002.....P........8111119..............85000000000049..................................................................................3000000000000
0000000000004111111111111115000004111111111111115000000000000411111111111111111111111111111111111111111111111111111111111111111111111111111111115000000000000
0000000000000000000000000000000000000000000000000000000000000000000000000000000000000000000000000000000000000000000000000000000000000000000000000000000000000
0000000000000000000000000000000000000000000000000000000000000000000000000000000000000000000000000000000000000000000000000000000000000000000000000000000000000
0000000000000000000000000000000000000000000000000000000000000000000000000000000000000000000000000000000000000000000000000000000000000000000000000000000000000
0000000000000000000000000000000000000000000000000000000000000000000000000000000000000000000000000000000000000000000000000000000000000000000000000000000000000
0000000000000000000000000000000000000000000000000000000000000000000000000000000000000000000000000000000000000000000000000000000000000000000000000000000000000